2 29 40 level3 outside-day
....................................................................................................
....................................................................................................
....................................................................................................
....................................................................................................
....................................................................................................
....................h...............................................................................
..................DEEEF.............................................................................
....................................................................................................
.......................................................................................JKKKKKKKKKKKK
.........................DEEF..........................................................PQQQQQQQQQQQQ
................................................................................DEF....PQQQQQQQQQQQQ
..............................DEEEEEF..................................................PQQQQQQQQQQQQ
.......................................................................................PQQQQQQQQQQQQ
...................................................................................DEF.PQQQQQQQQQQQQ
.......................................DEEEF...........................................PQQQQQQQQQQQQ
.......................................................................................PQQQQQQQQQQQQ
................................................DEF...........................DEF......PQQQQQQQQQQQQ
......................................................DF...............................PQQQQQQQQQQQQ
..................................................................DEEF.............DEF.PQQQQQQQQQQQQ
.........................................................DEEEF.........................PQQQQQQQQQQQQ
..........................................................................DEF..........PQQQQQQQQQQQQ
.......................................................................................PQQQQQQQQQQQQ
.......................................................................................PQQQQQQQQQQQQ
................................................................................ABC....PQQQQQQQQQQQQ
...............................JKKKKKKKKKKL............................................PQQQQQQQQQQQQ
...............................PQQQQQQQQQQR.................................ABC........PQQQQQQQQQQQQ
...............................PQQQQQQQQQQR............................................PQQQQQQQQQQQQ
..............ABC....YYYYYYY...PQQQQQQQQQQR............................................PQQQQQQQQQQQQ
.....................aaaaaaa...PQQQQQQQQQQR............................ABC.............PQQQQQQQQQQQQ
.....................acaaaba...PQQQQQQQQQQR............................................PQQQQQQQQQQQQ
HHHHHHHHHHHHHHHI..f..aiaaaaa...PQQQQQQQQQQR............................................PQQQQQQQQQQQQ
NNNNNNNNNNNNNNNNHHHHHHHHHHHHHHHHHHHHHHHHHHHHHHHHHHHHHHHHHHHHHHHHHHHHHHHHHHHHHHHHHHHHHHHHHHHHHHHHHHHH
NNNNNNNNNNNNNNNNNNNNNNNNNNNNNNNNNNNNNNNNNNNNNNNNNNNNNNNNNNNNNNNNNNNNNNNNNNNNNNNNNNNNNNNNNNNNNNNNNNNN
NNNNNNNNNNNNNNNNNNNNNNNNNNNNNNNNNNNNNNNNNNNNNNNNNNNNNNNNNNNNNNNNNNNNNNNNNNNNNNNNNNNNNNNNNNNNNNNNNNNN
NNNNNNNNNNNNNNNNNNNNNNNNNNNNNNNNNNNNNNNNNNNNNNNNNNNNNNNNNNNNNNNNNNNNNNNNNNNNNNNNNNNNNNNNNNNNNNNNNNNN
NNNNNNNNNNNNNNNNNNNNNNNNNNNNNNNNNNNNNNNNNNNNNNNNNNNNNNNNNNNNNNNNNNNNNNNNNNNNNNNNNNNNNNNNNNNNNNNNNNNN
NNNNNNNNNNNNNNNNNNNNNNNNNNNNNNNNNNNNNNNNNNNNNNNNNNNNNNNNNNNNNNNNNNNNNNNNNNNNNNNNNNNNNNNNNNNNNNNNNNNN
NNNNNNNNNNNNNNNNNNNNNNNNNNNNNNNNNNNNNNNNNNNNNNNNNNNNNNNNNNNNNNNNNNNNNNNNNNNNNNNNNNNNNNNNNNNNNNNNNNNN
NNNNNNNNNNNNNNNNNNNNNNNNNNNNNNNNNNNNNNNNNNNNNNNNNNNNNNNNNNNNNNNNNNNNNNNNNNNNNNNNNNNNNNNNNNNNNNNNNNNN
NNNNNNNNNNNNNNNNNNNNNNNNNNNNNNNNNNNNNNNNNNNNNNNNNNNNNNNNNNNNNNNNNNNNNNNNNNNNNNNNNNNNNNNNNNNNNNNNNNNN
19 30 GO AWAY!
